16 -144 -48 1 1
16 -144 -16 1 1
16 -144 16 1 1
16 -112 16 1 1
16 -112 -16 1 1
16 -112 -48 1 1
16 -80 -48 1 1
16 -80 -16 1 1
16 -80 16 1 1
16 -80 48 1 1
16 -80 80 1 1
16 -80 112 1 1
16 -80 144 1 1
16 -80 176 1 1
16 -112 176 1 1
16 -144 176 1 1
16 -144 144 1 1
16 -144 112 1 1
16 -144 80 1 1
16 -144 48 1 1
16 -112 48 1 1
16 -112 80 1 1
16 -112 112 1 1
16 -112 144 1 1
16 -48 48 1 1
16 -48 80 1 1
16 -16 80 1 1
16 16 80 1 1
16 48 80 1 1
16 80 80 1 1
16 112 48 1 1
16 112 80 1 1
16 112 112 1 1
16 144 112 1 1
16 144 144 1 1
16 144 176 1 1
16 176 176 1 1
16 208 176 1 1
16 208 144 1 1
16 208 112 1 1
16 208 80 1 1
16 208 48 1 1
16 208 16 1 1
16 208 -16 1 1
16 176 -16 1 1
16 176 -48 1 1
16 208 -48 1 1
16 176 16 1 1
16 176 48 1 1
16 176 80 1 1
16 176 112 1 1
16 176 144 1 1
16 144 80 1 1
16 144 48 1 1
16 144 16 1 1
16 144 -16 1 1
16 144 -48 1 1
16 112 -48 1 1
16 112 -16 1 1
16 112 16 1 1
16 -48 16 1 1
16 -48 -16 1 1
16 -48 -48 1 1
16 16 112 1 1
16 48 112 1 1
16 80 112 1 1
16 -16 112 1 1
16 -48 112 1 1
16 -48 144 1 1
16 -16 144 1 1
16 16 144 1 1
16 48 144 1 1
16 80 144 1 1
16 112 144 1 1
16 -80 208 1 1
16 -48 208 1 1
16 -48 240 1 1
16 -16 240 1 1
16 -16 272 1 1
16 16 272 1 1
16 16 304 1 1
16 48 304 1 1
16 48 272 1 1
16 80 272 1 1
16 80 240 1 1
16 112 240 1 1
16 112 208 1 1
16 144 208 1 1
16 112 176 1 1
16 80 176 1 1
16 48 176 1 1
16 -16 176 1 1
16 -48 176 1 1
16 16 176 1 1
16 48 208 1 1
16 80 208 1 1
16 16 208 1 1
16 -16 208 1 1
16 16 240 1 1
16 48 240 1 1
16 -16 48 1 1
16 80 48 1 1
