17 -336 -48 1 1
18 -304 -48 1 1
18 -272 -48 1 1
18 -240 -48 1 1
18 -208 -48 1 1
18 -176 -48 1 1
18 -144 -48 1 1
18 -112 -48 1 1
18 -80 -48 1 1
18 -48 -48 1 1
18 -16 -48 1 1
18 16 -48 1 1
18 48 -48 1 1
18 80 -48 1 1
18 112 -48 1 1
18 144 -48 1 1
18 176 -48 1 1
18 208 -48 1 1
19 240 -48 1 1
16 -48 -16 1 1
16 -48 16 1 1
16 -80 16 1 1
16 -80 -16 1 1
16 -112 -16 1 1
16 -80 48 1 1
16 -48 48 1 1
16 -16 48 1 1
16 16 48 1 1
16 48 48 1 1
16 48 16 1 1
16 48 -16 1 1
16 80 -16 1 1
16 80 16 1 1
16 16 80 1 1
